0000000000
0000000000
0100000000
0000000000
0000100000
0100000000
0101000000
0001000000
0000001000
0000000000
